
 ############
 ###########
 #############
 #################
 ###############
 #######
 ####################
 #############$